1,60 1,60 1,60 1,60 1,60 1,60 1,60 1,60 1,60 1,60 1,60 1,60 1,60 1,60 1,60 1,60 1,60 1,60 1,60 1,60 1,60 1,60 1,60 1,60 1,60 1,60 1,60 1,60 1,60 1,60 1,60 1,60 1,60 1,60 1,60 1,60 1,60
1,30 1,30 1,30 1,30 1,30 1,30 1,30 1,30 1,30 1,30 1,30 1,30 1,30 1,30 1,30 1,30 1,30 1,30 1,30 1,30 1,30 1,30 1,30 1,30 1,30 1,60 1,60 1,60 1,60 1,60 1,60 1,60 1,60 1,60 1,60
1,30 1,30 1,30 1,30 1,30 2,50 2,50 2,50 2,50 2,50 1,30 1,30 1,30 1,30 1,30 1,30 1,30 1,30 1,30 1,30 1,60 1,60 1,60 1,60 1,60
1,30 1,30 1,30 1,30 1,30 1,30 1,30 1,30 1,30 1,30 2,40 2,40 2,40 2,40 2,40 2,40 2,40 2,40 2,40 2,40 1,1 1,1 1,1 1,1 1,60 1,60 1,60 1,60 1,60
2,30 2,30 2,30 2,30 2,30 2,15 2,15 1,25 2,15 2,15 1,1 1,1 1,1 1,1 1,1 1,1 1,1 1,1 2,10 2,10
1,1 1,1 1,1 1,1 1,1 1,1 1,1 1,1 3,30 2,15 2,15 1,25 2,15 2,15 2,15 2,15 1,25 2,15 2,15 2,15 2,15 1,25 2,15 2,15 1,10 1,10 1,10 1,10 1,10
1,1 1,1 1,1 1,1 1,1 1,1 1,1 1,1 3,20 3,20 2,10 2,10 2,10 2,10 2,10 1,1 1,1 1,1 1,1 1,1 1,1 1,1 1,1 2,5 2,5 2,5 2,5 2,5 2,5 2,5 2,5 2,5 2,5
2,5 2,5 2,5 2,5 2,5 2,5 2,5 2,5 2,5 2,5 3,20 3,20 3,20 3,20 3,20 1,1 1,1 1,1 1,1 1,1 3,15 3,15 2,5 2,5 3,10 2,5 2,5 2,5 2,5 2,5 1,1 1,1 2,2 2,2
2,1 2,1 2,1 2,1 2,1 2,1 2,1 2,1 2,1 2,1 3,30 3,30 3,30 1,1 1,1 2,2 2,2 3,3 3,3 3,3 1,1 2,2 3,3 2,1 2,1 2,1 2,1 2,1 2,1 2,1 2,1 2,1 2,1 1,1 1,1 1,1 1,1 1,1 1,15 1,15 1,15
4,30 3,20 3,20 3,20 3,20 3,20 1,1 1,1 1,1 1,1 2,1 2,1 2,1 2,1 2,1 2,1 2,1 2,1 2,1 2,1 2,1 2,1 2,1 2,1 2,1 3,3 3,3 3,3 2,1 2,1 2,1 2,1 2,1 1,30 1,30 2,1 2,1 2,1 2,1 2,1 1,1 1,1 1,15 1,15
4,20 4,20 4,20 4,20 4,20 4,20 3,20 3,20 4,20 4,20 3,20 4,20 4,20 2,1 2,1 2,1 2,1 2,1 2,1 2,1 2,1 2,1 2,1 2,1 2,1 2,1 2,1 2,1 3,3 3,3 3,3 3,3 3,3 3,3 3,3 3,3 4,20 4,20 4,20 4,20 1,1 1,1 1,1 1,1 1,1 1,1 1,1
3,10 3,10 3,10 3,10 4,1 4,4 3,1 3,1 3,1 3,1 3,1 3,1 3,1 3,1 3,1 3,1 4,1 4,1 3,1 3,1 3,1 3,1 3,1 4,1 4,1 4,1 3,1 3,1 3,1 3,1 3,1 1,30 1,30 2,10 2,10 2,10 2,10
1,1 1,1 1,1 1,1 3,1 3,1 4,1 4,1 3,1 3,1 3,1 3,1 3,1 4,1 4,1 4,1 3,1 3,1 3,1 3,1 3,1 1,30 1,30 2,10 2,10 2,10 2,10
1,1 1,1 1,1 1,1 3,30 3,30 2,30 2,30 1,30 1,30 1,180 3,10 3,10 4,1 3,10 3,10 4,1 3,10 3,10 4,1 3,10 3,10 4,1 3,10 3,10 4,1 3,10 3,10 4,1 3,1 3,1 3,1 4,2 4,2 4,2 4,2 4,2 1,30
