11 11 11 11 11 11 11 11 11 11 11 11 11 11 11 11 11 11 11 11
11 11 11 11 11 11 11 11 11 11 31 30 30 30 30 31 11 11 11 11
11 11 11 11 11 11 11 11 11 11 30 50 50 50 50 30 11 11 11 11
11 11 11 11 11 11 11 11 11 11 30 50 50 50 50 30 11 11 11 11
32 30 30 31 11 11 11 11 11 11 31 30 30 31 50 30 11 11 11 11
11 11 50 30 50 11 11 11 11 11 11 11 11 30 11 31 30 30 31 11
11 11 11 30 50 31 30 30 31 11 11 11 11 30 11 11 50 50 30 11
11 11 11 30 50 30 50 50 30 11 11 11 11 30 11 11 50 50 30 11
11 11 11 31 30 31 50 50 30 50 11 11 11 30 50 50 11 11 30 11
11 11 11 11 11 11 11 11 31 30 30 30 30 31 50 50 11 11 30 11
11 11 11 11 11 11 11 11 11 11 50 50 50 11 11 31 30 30 31 11
11 11 11 11 11 11 11 11 11 11 11 11 11 11 11 30 50 11 11 11
11 11 11 11 11 11 11 11 11 11 11 11 11 11 11 33 11 11 11 11

