15 15 15 15 15 15 15 15 15 15 15 15 15 15 15 15 15 15 15 15
15 15 15 15 15 15 15 15 15 15 15 15 15 15 15 15 15 15 15 15
15 15 15 15 15 15 15 15 15 15 15 15 15 15 15 15 15 15 15 15
15 15 15 15 15 15 15 15 15 15 15 15 15 15 15 15 15 15 15 15
15 15 15 15 15 15 15 15 15 15 15 15 15 15 15 15 15 15 15 15
15 15 15 15 15 15 15 15 15 15 15 15 15 15 15 15 15 15 15 15
15 15 15 15 15 15 15 15 15 15 15 15 31 30 30 30 30 30 30 32
15 15 15 15 15 15 15 15 15 15 15 15 30 50 50 50 50 50 50 50
15 15 15 15 15 15 15 15 15 15 15 15 30 50 50 50 50 50 50 50
15 15 15 15 15 15 15 15 15 15 15 15 30 50 50 50 50 50 50 50
15 15 15 15 15 15 15 15 15 15 15 15 30 50 50 50 50 50 50 50
15 15 15 15 15 15 15 15 15 15 15 15 30 50 50 50 50 50 50 50
15 15 15 15 15 15 15 15 15 15 15 15 31 50 50 50 50 50 50 50