1,120 1,120 1,120 1,120 2,120 2,120 2,120
2,120 2,120 2,120 2,120 2,120 2,120 3,120 1,120 2,120
1,120 2,120 1,120 2,120 1,120 3,120 2,120 1,120 3,120 3,120 4,120 1,120 2,120
1,120 1,120 3,120 3,120 3,120 2,120 1,120 2,120 3,120 2,120 1,120 2,120 4,120 4,120 4,120 3,120 3,120
3,120 3,120 3,120 3,120 3,120 3,120 3,120 3,120 3,120 2,120 2,120 1,120 1,120 1,120 3,120 3,120 3,120 3,120 4,120 4,120
3,120 3,120 3,120 3,120 3,120 3,120 4,120 4,120 4,120 4,120 2,120 2,120 2,120 2,120 3,120 3,120 3,120 3,120 3,120 3,120 3,120 3,120 3,120 3,120 3,120 3,120 3,120
4,120 4,120 4,120 3,120 3,120 3,120 3,120 3,120 3,120 3,120 3,120 3,120 3,120 3,120 3,120 3,120 3,120 3,120 2,120 2,120 2,120 2,120 2,120 1,120 2,120 1,120 2,120 3,120 3,120 3,120 3,120 4,120 3,120 3,120 3,120 3,120
3,120 2,120 3,120 2,120 3,120 2,120 3,120 2,120 3,120 2,120 3,120 2,120 3,120 2,120 4,120 3,120 4,120 3,120 4,120 3,120 4,120 2,120 3,120 3,120 3,120 3,120 3,120 3,120 3,120 3,120 3,120 2,120 2,120 2,120 2,120 2,120 2,120 2,120 2,120 2,120 2,120 2,120 2,120 2,120 2,120
3,120 3,120 3,120 3,120 3,120 3,120 3,120 3,120 3,120 3,120 3,120 3,120 3,120 3,120 3,120 3,120 3,120 3,120 4,120 4,120 4,120 4,120 4,120 4,120 4,120 4,120 4,120 4,120 4,120 4,120 4,120 3,120 3,120 3,120 2,120 2,120
3,120 3,120 3,120 3,120 3,120 4,120 4,120 3,120 3,120 4,120 4,120 3,120 3,120 4,120 4,120 3,120 3,120 4,120 4,120 3,120 3,120 4,120 4,120 3,120 3,120 4,120 4,120 3,120 3,120 4,120 3,120 4,120 3,120 4,120 3,120 3,120 4,120 4,120 4,120 4,120 4,120 4,120 4,120 3,120 4,120 2,120 2,120 2,120