10 10 10 10 10 10 10 10 10 10 10 10 10 10 10 10 10 10 10 10
10 10 10 10 10 31 30 31 10 10 10 10 10 10 10 31 30 31 10 10
10 10 10 10 10 30 50 30 10 10 10 10 10 10 10 30 50 30 10 10
10 10 10 10 10 30 50 31 30 30 30 31 10 10 10 30 50 30 10 10
10 10 10 10 10 30 10 10 10 10 50 30 10 10 10 30 50 30 10 10
10 10 10 10 10 30 10 10 10 10 10 30 10 10 10 30 50 30 10 10
10 10 10 50 50 30 10 10 10 10 10 30 10 10 10 30 50 31 30 32
10 10 10 50 50 30 10 10 10 10 10 30 31 10 10 30 10 10 10 10
33 30 30 30 30 31 10 10 10 10 10 10 30 50 50 30 10 10 10 10
10 10 10 10 10 10 10 10 10 10 10 10 30 50 50 31 30 30 31 10
10 10 10 10 10 10 10 10 10 10 10 10 30 50 50 50 50 50 30 10
10 10 10 10 10 10 10 10 10 10 10 10 31 30 30 31 50 50 30 10
10 10 10 10 10 10 10 10 10 10 10 10 10 10 10 31 30 30 31 10
