11 11 11 11 11 11 11 11 11 11 11 11 11 11 11 11 11 11 11 11
11 11 11 11 11 11 11 11 11 11 11 11 11 11 11 11 11 11 11 11
11 11 11 11 11 11 11 11 11 11 11 11 11 11 11 11 11 11 11 11
10 50 50 50 11 11 11 11 11 11 11 11 11 11 11 11 11 11 11 11
32 30 31 10 11 11 11 11 11 11 11 11 11 11 11 11 11 11 11 11
10 50 30 50 11 11 11 11 11 11 11 11 11 11 11 11 11 11 11 11
10 50 30 10 11 11 11 11 11 11 11 11 11 11 11 11 11 11 11 11
11 10 30 50 10 50 10 10 10 10 11 11 11 11 11 11 11 11 11 11
11 10 31 30 30 30 30 30 31 50 10 10 10 10 10 10 10 11 11 11
11 10 10 50 10 10 50 10 30 50 31 30 30 30 30 31 10 11 11 11
11 11 11 11 11 11 11 10 31 30 31 50 10 10 50 30 50 11 11 11
11 11 11 11 11 11 11 10 50 50 50 10 11 11 10 30 10 11 11 11
11 11 11 11 11 11 11 11 11 11 11 11 11 11 10 33 10 11 11 11
