14 14 14 14 14 14 14 14 14 14 14 14 14 14 14 14 14 14 14 14
32 30 31 14 14 14 14 14 14 14 14 14 14 14 14 14 14 14 14 14
14 14 31 31 50 14 14 14 14 14 14 14 14 14 31 30 31 14 14 14
14 50 50 30 50 14 14 14 14 14 14 14 14 14 30 50 30 50 14 14
14 14 50 31 30 30 30 31 14 14 14 14 14 14 30 14 31 31 14 14
14 14 14 50 14 14 50 30 50 14 14 14 14 50 30 14 14 30 14 14
14 14 14 14 14 14 14 30 50 31 30 31 14 50 30 14 14 30 14 14
14 14 14 14 14 14 50 31 30 31 50 31 30 30 31 14 50 30 50 50
14 14 14 14 14 14 14 14 14 14 14 14 14 14 14 14 14 31 30 33
14 14 14 14 14 14 14 14 14 14 14 14 14 14 14 14 14 50 50 50
14 14 14 14 14 14 14 14 14 14 14 14 14 14 14 14 14 14 14 14
14 14 14 14 14 14 14 14 14 14 14 14 14 14 14 14 14 14 14 14
14 14 14 14 14 14 14 14 14 14 14 14 14 14 14 14 14 14 14 14
