12 12 12 12 12 12 12 12 12 12 12 12 12 12 12 12 12 12 12 12
32 30 31 12 12 12 12 12 12 12 12 12 12 12 12 12 12 12 12 12
12 12 31 31 50 12 12 12 12 12 12 12 12 12 31 30 31 12 12 12
12 50 50 30 50 12 12 12 12 12 12 12 12 12 30 50 30 50 12 12
12 12 50 31 30 30 30 31 12 12 12 12 12 12 30 12 31 31 12 12
12 12 12 50 12 12 50 30 50 12 12 12 12 50 30 12 12 30 12 12
12 12 12 12 12 12 12 30 50 31 30 31 12 50 30 12 12 30 12 12
12 12 12 12 12 12 50 31 30 31 12 31 30 30 31 12 50 30 50 50
12 12 12 12 12 12 12 12 12 12 12 12 12 12 12 12 12 31 30 33
12 12 12 12 12 12 12 12 12 12 12 12 12 12 12 12 12 50 50 50
12 12 12 12 12 12 12 12 12 12 12 12 12 12 12 12 12 12 12 12
12 12 12 12 12 12 12 12 12 12 12 12 12 12 12 12 12 12 12 12
12 12 12 12 12 12 12 12 12 12 12 12 12 12 12 12 12 12 12 12
