13 13 13 13 13 13 13 13 13 13 13 13 13 13 13 13 13 13 13 13
13 13 13 13 13 13 13 13 13 13 13 13 31 30 30 30 30 30 30 32
13 13 13 13 13 13 13 13 13 13 13 13 30 50 50 13 13 13 13 13
13 13 13 13 13 13 13 13 13 13 13 13 31 31 50 13 13 13 13 13
13 13 13 13 13 13 13 13 13 13 13 13 50 30 50 13 13 13 13 13
13 13 13 13 13 13 13 13 13 13 13 13 50 30 50 13 13 13 13 13
13 13 13 13 13 13 13 13 13 13 13 13 50 30 50 13 13 13 13 13
13 13 13 13 13 13 13 13 13 13 13 13 50 30 50 13 13 13 13 13
13 13 13 13 13 13 13 13 13 31 30 30 30 31 50 13 13 13 13 13
13 13 13 13 13 13 13 13 13 30 50 50 13 13 13 13 13 13 13 13
13 13 13 13 13 13 13 13 13 30 50 50 13 13 13 13 13 13 13 13
13 13 13 13 13 13 13 13 13 30 13 13 13 13 13 13 13 13 13 13
13 13 13 13 13 13 13 13 13 33 13 13 13 13 13 13 13 13 13 13